34 14
1 1 1 1 1 1 1 1 1 1 1 1 1 1 1 1 1 1 1 1 1 1 1 1 1 1 1 1 1 1 1 1 1 1
1 1 1 1 1 1 1 1 1 1 1 1 1 1 1 1 1 1 1 1 1 1 1 1 1 1 1 1 1 1 1 1 1 1
1 1 1 1 1 1 1 1 1 1 1 1 1 1 1 1 1 1 1 1 1 1 1 1 1 1 1 1 1 1 1 1 1 1
1 1 1 1 1 1 1 1 3 1 1 1 1 1 1 1 1 1 1 1 1 1 1 1 1 1 1 1 1 1 1 1 1 1
1 1 1 1 1 1 1 1 1 1 1 1 1 1 1 1 1 1 1 1 1 1 1 1 1 1 1 1 1 1 1 1 1 1
1 1 1 1 1 1 1 1 1 1 1 1 1 10 1 1 1 1 1 1 1 1 1 1 1 1 1 1 1 1 1 1 1 1
1 1 1 1 1 1 1 1 1 1 1 8 8 8 1 1 1 1 1 1 3 1 1 1 1 1 1 1 1 1 1 1 1 1
1 1 1 1 1 1 1 1 1 1 1 8 8 8 1 1 1 1 1 1 1 1 1 1 1 8 8 8 1 1 1 1 1 1
1 1 1 1 8 8 8 6 1 5 11 11 7 1 1 1 1 1 1 1 1 1 1 5 11 8 8 8 1 1 1 1 1 1
1 1 1 5 8 8 8 1 1 1 1 1 4 1 1 1 1 1 0 9 1 1 1 1 1 1 4 1 1 1 1 1 1 1
1 1 1 1 1 7 1 1 1 1 1 5 7 6 1 1 1 0 0 0 0 1 1 1 1 5 7 1 1 1 1 1 1 1
1 1 1 1 10 7 9 1 1 1 1 1 7 1 1 1 0 0 0 0 0 0 1 1 1 9 7 1 1 1 1 1 1 1
0 0 0 0 0 0 0 0 0 14 14 14 0 0 0 0 0 0 0 0 0 0 0 0 0 0 0 0 0 0 0 0 0 0
2 2 2 2 2 2 2 2 2 16 16 16 2 2 2 2 2 2 2 2 2 2 2 2 2 2 2 2 2 2 2 2 2 2